NO ./includes/textures/light_wall.xpm
SO ./includes/textures/night_fence.xpm
WE ./includes/textures/stone_wall.xpm
EA ./includes/textures/night_grass.xpm
DO ./includes/textures/wood_door.xpm

F 0,0,0
C 0,0,0

1111
1001111111111111111111111111111111
1002000000000000000000000000000001
1S01111111111111111111111100000001
1001                     1000000011111111111111111111111
1001                     1000000020000000000000000000001
1001                     1000000020000001100010000000001
1001                     1000000011110000000000000000001
1001                     100000001  10000000010000000001
1001                     111000001  11111111111111111111
1001                     111121111
1211                     100000011
1011                     100000001
1011                     100000001
1211                     100000001
1001111111111111111111111100000001
1000000000000000000000000100000001
1000000000000000000000000200000111
1111111111111111111111111111111111