NO /home/brunhenr/cube3D/Cub3D/includes/textures/light_wall.xpm
SO /home/brunhenr/cube3D/Cub3D/includes/textures/moss_wall.xpm
WE /home/brunhenr/cube3D/Cub3D/includes/textures/stone_wall.xpm
EA /home/brunhenr/cube3D/Cub3D/includes/textures/wood_wall.xpm

F 220,100,0
C 225,30,0

111111111
100000011
1N0000011
100000011
100000011
100000011
110000111
111111111